/	mainapp.views.index	index	login_required
/admin/categories/	adminapp.views.categories	adminapp:categories
/admin/categories/create/	adminapp.views.view	adminapp:category_create
/admin/categories/delete/<int:pk>/	adminapp.views.view	adminapp:category_delete
/admin/categories/update/<int:pk>/	adminapp.views.view	adminapp:category_update
/admin/products/<int:pk>/	adminapp.views.products	adminapp:products
/admin/products/create/<int:pk>/	adminapp.views.view	adminapp:product_create
/admin/products/delete/<int:pk>/	adminapp.views.product_delete	adminapp:product_delete
/admin/products/read/<int:pk>/	adminapp.views.view	adminapp:product_read
/admin/products/update/<int:pk>/	adminapp.views.view	adminapp:product_update
/admin/users/	adminapp.views.view	adminapp:users
/admin/users/create/	adminapp.views.user_create	adminapp:user_create
/admin/users/delete/<int:pk>/	adminapp.views.user_delete	adminapp:user_delete
/admin/users/update/<int:pk>/	adminapp.views.user_update	adminapp:user_update
/auth/edit/	authapp.views.edit	authapp:edit
/auth/login/	authapp.views.login	authapp:login
/auth/logout/	authapp.views.logout	authapp:logout
/auth/register/	authapp.views.register	authapp:register
/auth/verify/<email>/<activation_key>/	authapp.views.verify	authapp:verify
/basket/	basketapp.views.basket	basketapp:basket
/basket/add/<int:pk>/	basketapp.views.basket_add	basketapp:basket_add
/basket/edit/<int:pk>/<quantity>/	basketapp.views.basket_edit	basketapp:basket_edit
/basket/remove/<int:pk>/	basketapp.views.basket_remove	basketapp:basket_remove
/complete/<str:backend>/	social_django.views.complete	social:complete
/contacts/	mainapp.views.contact	contacts
/disconnect/<str:backend>/	social_django.views.disconnect	social:disconnect
/disconnect/<str:backend>/<int:association_id>/	social_django.views.disconnect	social:disconnect_individual
/login/<str:backend>/	social_django.views.auth	social:begin
/orders/	ordersapp.views.view	ordersapp:list
/orders/complete/<pk>	ordersapp.views.complete	ordersapp:complete
/orders/create/	ordersapp.views.view	ordersapp:create
/orders/delete/<pk>	ordersapp.views.view	ordersapp:delete
/orders/product/<pk>/price/	ordersapp.views.product_price	ordersapp:product_price
/orders/read/<pk>	ordersapp.views.view	ordersapp:read
/orders/update/<pk>	ordersapp.views.view	ordersapp:update
/products/	mainapp.views.products	products:products
/products/<int:pk>	mainapp.views.products	products:category
/products/<int:pk>/<int:page>/	mainapp.views.products	products:product_paginate
/products/product/<int:pk>/	mainapp.views.product	products:product
